NO ./textures/Blue.xpm
SO ./textures/Green.xpm
WE ./textures/Pink.xpm
EA ./textures/Red.xpm

F 255,255,255
C 255,255,255

111111111111
100000000001
100000000001
1000E0010001
100000100001
100100000001
100000000001
111111111111