NO ./textures/brick.xpm
SO ./textures/grass.xpm
WE ./textures/musgo.xpm
EA ./textures/stoner.xpm

F 220,100,0
C 225,30,0

        1111111111111111111111111
        1000000000110000000000001
        1000000001110000000000001
        1000000000000000000000001
111111111001100100110000000000001
100000000011000001110111111111101
11110111111111011100000010001 111
11110111111111111101010010001     1111111
11000000110101011100000010001     1000001
10000000W00000001100000010001     1111111
10000000000000001101010000001
1100000111010101111111111000111
11110111 1110101   1 11000001
11111111 1111111 111111111011
                        10001
                        11011
                         111